espatlla	hombro
rauxa	arrebato
ham	anzuelo
clatell	nuca
gendre	yerno
nora	nuera
tafaner	mirón
mitjons	calcetines
ase	asno
gripau	sapo
colom	paloma
sargantana	lagartija
xai	cordero
pitroig	pelirrojo
fardatxo	lagarto
pany	cerradura
desaiguador	desagüe
canonada	tubería
emboçar	embozar
façana	fachada
rebost	despensa
engrunsadora	columpio
engrunsar-se	columpiarse
fanal	farola
gual	vado
estany	estanque
vedell	cordero
arc de Sant Martí	arcoíris
xàfec	aguacero
rosada	rocío
agranar	barrer
granera	escoba
renyó	riñón
parpella	párpado
bigot	bigote
barruga	verruga
piga	lunar
trena	trenza
abella	abeja
abellot	zángano
àlber	álamo
alfàbega	albahaca
all	ajo
alzina	encina
ametler	almendro
amfibi	anfibio
ànec	pato
ase	asno
avet	abeto
banya	cuerno
anyell	cordero
bestiola	bicho
blat	trigo
borinot	abejorro
bou	toro
branca	rama
cadell	cachorro
cadernera	jilguero
caragol	caracol
cau	madriguera
ceba	cebolla
centpeus	ciempiés
cérvol	ciervo
cigne	cisne
cigonya	cigüeña
cloïssa	almeja
clòtxina	mejillón
colobra	culebra
colom	palomo
conill	conejo
cranc	cangrejo
cuc	gusano
dacsa	maíz
desmai	sauce
dofí	delfín
egua	yegua
eriçó	erizo
eruga	oruga
escarabat	escarabajo
escurçó	víbora
espígol	espliego
esquirol	ardilla
estruç	avestruz
faig	haya
falcó	halcón
fardatxo	lagarto
femella	hembra
fenoll	hinojo
figuera	higuera
formiga	hormiga
fusta	madera
gàbia	jaula
garrofer	algarrobo
gavina	gaviota
gessamí	jazminero
gos	perro
granota	rana
gripau	sapo
guatlla	codorniz
indiot	pavo
julivert	perejil
linx	lince
llebre	liebre
llop	lobo
llorer	laurel
lluç	merluza
lluerna	luciérnaga
magraner	granado
mascle	macho
mussol	mochuelo
niu	nido
ocell	ave
òliba	lechuza
olivera	olivo
ordi	cebada
orenga	orégano
oronella	golondrina
ós	oso
ovella	oveja
panereta	mariquita
panerola	cucaracha
paó	pavo real
papallona	mariposa
pardal	pájaro
perdiu	perdiz
pi	pino
planter	vivero
poll	piojo
pollastre	pollo
poltre	potro
pomera	manzano
porc	cerdo
porc senglar	jabalí
prunera	ciruelo
puça	pulga
rabosa	zorra
ramat	rebaño
rata penada	murciélago
ratolí	ratón
rèptil	reptil
rosegador	roedor
rosella	amapola
rossinyol	ruiseñor
roure	roble
ruc	burro
rusc	colmena
saltamartí	saltamontes
sargantana	lagartija
sègol	centeno
serp	serpiente
somera	burra
surera	alcornoque
talp	topo
taronger	naranjo
tauró	tiburón
teuladí	gorrión
timonet	tomillo
tonyina	atún
truita	trucha
truja	cerda
ullal	colmillo
urpa	garra
vespa	avispa
voltor	buitre
xiprer	ciprés
xitxarra	cigarra
xop	chopo
zebra	cebra
peixateria	pescadería
carnisseria	carnicería
embotits	embutido
prestatgeria	estantería
llauna	lata
ou	huevo
cistell	cesta
tomàquet	tomate
cabàs	capazo
meló	melón
pinya	piña
espàrrec	espárrago
plàtan	plátano
pebrot	pimiento
davantal	delantal
bolet	seta
vi negre	vino tinto
llenties	lentejas
cigrons	garbanzos
mantega	mantequilla
meló	melón
taulell	mostrador
salsitxa	salchicha
lluç	merluza
polp	pulpo
cloïsses	almejas
clotxines	mejillones
musclos	moluscos
rap	rape
sèpia	sepia
llagosta	langosta
gamba	gamba
corró	rodillo
pa de motlle	pan de molde
alvocat	aguacate
albercoc	albaricoque
cirera	cereza
llimona	lima
figa	higo
maduixa	fresa
gerdó	
mangrana	granada
kiwi	kiwi
mandarina	mandarina
pera	pera
poma	manzana
prèssec	melocotón
xirimoia	chirimoya
meló d'aigua	sandía
raïm	uva
pruna	ciruela
pinya	piña
albergina	berenjena
carbassó	calabacín
carxofa	alcachofa
julivert	perejil
api	apio
coliflor	coliflor
col	col
fava	haba
ceba	cebolla
enciam	lechuga
mongeta	judía
endívia	endivia
bleda	acelga
escarola	escarola
moniato	boniato
patata	patata
espinacs	espinacas
nap	nabo
blat de moro	maíz
pèsols	guisantes
cogombra	pepino
safanoria	zanahoria
remolatxa	remolacha
rave	rábano
xirivia	chirivía
porro	puerro
menta	menta
tila	tila
camamilla	camomila
romaní	romero
sàlvia	salvia
til:la	tila
tofona	trufa
safrà	azafrán
pebre	pimienta
clau	clavo
canyella	canela
melindro	bizcocho
tortell	roscón
braç de gitano	brazo de gitano
torró	turrón
bunyol	buñuelo
galeta	galleta
tortell	roscón
rebosteria	repostería
bombó	bombón
pasta seca	pasta
bròquil	brócoli
aigüera	fregadero
tap	tapón
desagüe	desguàs
tovalló	servilleta
estovalla	mantel
paño	drap
manyopla	manopla
sotagot	posavaso
safata	bandeja
vaixella	vajilla
coberteria	cubertería
ampolla	botella
gerra	jarra
tassa	taza
copa	copa
setrill	aceitera
pot	bote
coberts	cubiertos
cullera	cuchara
forquilla	tenedor
ganivet	cuchillo
tisores	tijeras
batedor	batidor
cullerot	cucharón
escumadora	espumadera
colador	colador
espàtula	espátula
destral	hacha
obreampolles	abridor
llevataps	abridor
obrellaunes	abrelatas
ratlladora	ralladora
glaçonera	cubitera
morter	mortero
cassola	cazuela
olla	olla
cassó	cazo
paella	sartén
escorredora	escurridera
tapadora	tapa
mandonguilles	albóndigas
bullir	hervir
rostir	asar
fregir	freír
coure	cocer
batre	batir
abric	abrigo
americana	americana
anorac	anorak
anorac de plomes	plumíferos
banyador	bañador
barnús	albornoz
bata	bata
batí	batín
bermudes	bermudas
biquini	biquini
blazer	blazer
bodi	body
boina	boina
bombatxos	pantalón bombacho
bossa	bolso
bota	bota
botí	botín
botó	botón
botons de puny	gemelos
bragues	bragas
bragueta	bragueta
brusa	blusa
bufanda	bufanda
butxaca	bolsillo
caçadora	cazadora
calça	media
calcetí	calcetín
calçotets	calzoncillos
calfador	calentador
camal	pernera
camisa	camisa
camisó	camisón
camiseta	samarreta
cangur	canguro
barret	sombrero
caputxa	capucha
càrdigan	cárdigan
casaca	casaca
cinturó	cinturón
coll	cuello
corbata	corbata
corbatí	corbatín,
corretja	correa
cotó	algodón
cremallera	cremallera
cuiro	cuero
dependent	dependiente
dessuadora	sudadera
eslip	eslip
esmòquing	esmoquin
espardenya	alpargata
faixa	faja
falda	falda
frac	frac
fulard	fular
gavardina	gabardina
gorra	gorra
granota	mono
guant	guante
impermeable	impermeable
jaqueta	chaqueta
jersei	jersey
jupetí	chaleco
katiuska	katiuska
leotards	leotardos
licra	licra
llana	lana
lli	lino
malles	mallas
mànega	manga
manyopla	manopla
minifalda	minifalda
mitó	mitón
mocador	pañuelo
mocassí	mocasín
musclera	hombrera
pantalons	pantalones
pantis	pantis
pantofla	pantufla
parca	parka
peüc	peúco,
pijama	pijama
pitxi	pichi
polo	polo
ponxo	poncho
provador	probador
rebeca	rebeca
sabata	zapato
sabatilla	zapatilla
sahariana	sahariana
sandàlia	sandalia
sinagües	enaguas
sostenidors	sujetador
suèter	suéter
tanga	tanga
tirants	tirantes
top	top
trau	ojal
túnica	túnica
turbant	turbante
vaquers	vaqueros
vestit	vestido
xal	chal
xancleta	chancleta
xandall	chándal
aigüera	fregadero
aixeta	grifo
algeps	yeso
aljub	aljibe
altaveu	altavoz
andana	buhardilla
ansa	asa
armari de paret	armario empotrado
aspiradora	aspirador
balcó	balcón
balustrada	balaustrada
bany	baño
banyera	bañera
barana	barandilla
barandat	tabique
batedora	batidora
bidet	bidé
bombeta	bombilla
bressol	cuna
bugada	colada
butaca	sillón
cadenat	candado
cadira	silla
calaix	cajón
calaixera	cómoda
calfador	calentador
canelobre	candelabro
canonada	tubería
catifa	alfombra
celler	bodega
celobert	patio de luces
cendrer	cenicero
claraboia	tragaluz
clau	llave
clau	clavo
clau de pas	llave de paso
coberteria	cubertería
coixí	almohada
comandament	mando
corredor	pasillo
cortineta	visillo
cresol	candil
cristalleria	cristalería
cuina	cocina
cullera	cuchara
despatx	despacho
dipòsit	depósito
dormitori	dormitorio
dutxa	ducha
eixugador	secador
electrodomèstic	electrodoméstico
endoll	enchufe
engrunsadora	mecedora
escala	escalera
granera	escoba
escombraries	basura
escriptori	escritorio
esglaó	escalón
mirall	espejo
espremedora	exprimidor
espurna	chispa
estenedor	tendedero
estora	alfombrilla
façana	fachada
fanal	farol
farmaciola	botiquín
filferro	alambre
finestra	ventana
finestral	ventanal
finestró	postigo
flassada	manta
foguer	fogón
forn	horno
forqueta	tenedor
forrellat	cerrojo
fregall	estropajo
fregidora	freidora
gàbia	jaula
galeria	galería
ganivet	cuchillo
garatge	garaje
gerra	jarra
gerro	florero
gespa	césped
golfes	buhardilla
got	vaso
graella	parrilla
gratacel	rascacielos
guix	escayola
habitació	habitación
habitatge	vivienda
liquadora	licuadora
fumeral	chimenea
llauna	lata
lleixiu	lejía
llençol	sábana
llenya	leña
llit	cama
llitera	litera
llum	luz
mànec	mango
maneta	manilla
manovella	manivela
matalàs	colchón
menjador	comedor
microones	microondas
moble	mueble
motlura	moldura
obrellaunes	abrelatas
obridor	abridor
ordinador	ordenador
paella	sartén
pany	cerradura
parallamps	pararrayos
parquet	parqué
passamà	pasamanos
penell	veleta
penja-robes	percha
pica	pila
pinta	peine
pitxer	jarro
placa de cocció	encimera
planxa	plancha
poal	cubo
pols	polvo
pou	pozo
prestatge	estante
prestatgeria	estantería
rajola	ladrillo
raspall	cepillo
rebedor	recibidor
rebost	despensa
reixa	reja
rentadora	lavadora
rentaplats	lavavajillas
replanell	rellano
sabó	jabón
safareig	lavadero
safata	bandeja
setrill	aceitera
setrilleres	vinagreras
sòcol	zócalo
sòl	suelo
sostre	techo
soterrani	sótano
sucrera	azucarero
suro	corcho
tamboret	taburete
tanca	valla
tap	tapón
tassa	taza
taula	mesa
taulellet	azulejo
telèfon	teléfono
terrat	terraza
test	tiesto
teula	teja
teulada	tejado
tisores	tijeras
torradora	tostador
tub fluorescent	tubo fluorescente
vaixella	vajilla
vernís	barniz
vidriola	hucha
xemeneia	chimenea
anul·lació	anulación
aquàtic	acuático
arbitratge	arbitraje
àrbitre	árbitro
automobilisme	automovilismo
autopassada	autopase
avançar	avanzar
banqueta	banquillo
bàsquet	baloncesto
blocatge	blocaje
bombejar	bombear
boxeig	boxeo
busseig	buceo
cabotada	cabezazo
caça	caza
calfament	calentamiento
centrecampista	centrocampista
cistella	canasta
cursa	carrera
davanter	delantero
defendre	defender
defensiu	defensivo
descompte	descuento
disc	disco
puntada	patada
dretà	diestro
driblatge	regate
encaixar	encajar
entrebancar	zancadillear
escacs	ajedrez
esportista	deportista
esquerrà	zurdo
esquí	esquí
estadi	estadio
braça	braza
palometa	mariposa
traveta	zancadilla
futbet	futbito
gespa	césped
gimnàs	gimnasio
gimnàstica	gimnasia
golejar	golear
graderia	grada
graella d’eixida	parrilla de salida
guanyar	ganar
handbol	balonmano
hoquei	hockey
javelina	jabalina
birles	bolos
llançament	lanzamiento
llotja	palco
marcatge	marcaje
martell	martillo
marxa	marcha
matx	match
migcampista	centrocampista
muntanyisme	montañismo
natació	natación
nedador	nadador
nedar	nadar
pal	poste
passada	pase
patinatge	patinaje
pedrera	cantera
penal	penalti
perdre	perder
perxa	pértiga
pilota	pelota
planxa	tabla
preescalfament	precalentamiento
rebutjar	despejar
recordista	recordman
regatejar	regatear
relleus	relevos
rematada	remate
replegament	repliegue
represa	reanudación
rugbi	rugby
salt d’alçada	salto de altura
salt de llargària	salto de longitud
salt de perxa	salto de pértiga
servici	saque
sorteig	sorteo
substitució	sustitución
surf de neu	snowboard
tanques	vallas
tennis	tenis
ping-pong	ping-pong
tir	tiro
tir amb arc	tiro con arco
travesser	larguero
traveta	zancadilla
trenar	trenzar
trofeu	trofeo
vestidors	vestuarios
xarxa	red
xiular	silbar
xiulet	silbato
xiulit	silbido
xut	chut
xutar	chutar
abdomen	abdomen
aixella	axila
anou del coll	nuez
anus	ano
apèndix	apéndice
artell	nudillo
artèria	arteria
avantbraç	antebrazo
barbeta	barbilla
bescoll	nuca
bessons	gemelos
bíceps	bíceps
boca	boca
braça	brazo
bronqui	bronquio
bufeta	vejiga
cabells	cabello
cama	pierna
campaneta	campanilla
canella	caño
cap	cabezazo
cara	cara
cartílag	cartílago
cella	ceja
cervell	cerebro
clau	colmillo
clavícula	clavícula
coll	cuello
còlon	colon
columna vertebral	columna vertebral
colze	codo
copró	rabadilla
cor	corazón
coroneta	coronilla
costella	costilla
crani	cráneo
cuixa	muslo
cul	culo
dent	diente
dit anular	dedo anular
dit del mig	dedo corazón
dit xicotet	dedo meñique
polze	dedo pulgar
dit índex	dedo índice
dors	dorso
empenya	empeine
engonal	ingle
esòfag	esófago
espatla	paletilla
esquelet	esqueleto
esquena	espalda
estern	esternón
estòmec	estómago
faringe	faringe
fetge	hígado
front	frente
galta	mejilla
gangli	ganglio
geniva	encía
genoll	rodilla
gluti	glúteo
gola	garganta
intestí	intestino
incisiva	incisivo
juntura	articulación
laringe	laringe
llavi	labio
lòbul	lóbulo
mà	mano
maluc	cadera
mamella	mama
mandíbula	mandíbula
medul·la espinal	médula espinal
melic	ombligo
melsa	bazo
moll de l'òs 	tuétano
monyica	muñeca
mugró	pezón
muscle	hombro
múscul	músculo
nas	nariz
natja	nalga
nervi	nervio
orella	oreja
òrgan	órgano
os	hueso
ovari	ovario
paladar	paladar
palmell de la mà	palma de la mano
pàncrees	páncreas
panxa	barriga
pèl	pelota
pell	piel
parpella	párpado
penis	pene
pestanya	pestaña
peu	pie
pit	pecho
planta del peu	planta del pie
pols	sien
pòmul	pómulo
pubis	pubis
pulmó	pulmón
puny	puño
pupil·la	pupila
queixal	muela
recte	recto
renyó	riñón
sang	sangre
talo	talón
tòrax	tórax
tendó	tendón
testicle	testículo
tou de la cama	pantorrilla
trapezi	trapecio
tronc	tronco
turmell	tobillo
ull	ojo
ungla	uña
uretra	uretra
úter	útero
vagina	vagina
vas sanguini	vaso sanguíneo
vena	vena
ventre	vientre
vèrtebra	vértebra
vesícula	vesícula
vulva	vulva
avaria	avería
margda	esmeralda
emparar	amparar
gelea	jalea
vernís	barniz
aixovar	ajuar
assortir	surtir
cònsol	cónsul
corba	curva
estoig	estuche
nodrir	nutrir
rètol	letrero
rossinyol	ruiseñor
tamboret	taburete
tolit	tullido
tomba	tumba
turment	tormento
pessic	pellizco
poruc	miedoso
arrap	arañazo
amorosir	suavizar
caserna	cuartel
atzucar	callejón
metzina	veneno
atzabeja	azabache
simbomba	zambomba
sofre	azufre
esbós	esbozo
esprèmer	exprimir
arrisar	rizar
gessamí	jazmín
pòlissa	pòliza
hissar	izar
rossí	rocín
benzina	gasolina
topaci	topacio
cossiol	maceta
rondanxa	rodaja
barrejar	mezclar
moc	moco
fugida	huida
recepta	receta
esbrinar	averiguar
gruix	grueso
cotna	corteza
setciències	sabihondo
orgue	órgano
retaule	retablo
llémena	liendre
jou	yugo
tou	blando
graella	tabla
barnús	barniz
vertigen	vértigo
vorejar	rodear
estavellar	estrellarse
malson	pesadilla
treva	tregua
baf	vaho
bena	venda
besllum	atisbo
debanar	devanar
desimbolt	desenvuelto
riba	orilla
saba	savia
bava	baba
escovilló	escobillón
sivella	hebilla
jaure	yacer
corretja	correa
enutjar	enojar
petjar	pisar
pitjar	pulsar
trepitjar	pisar
disbauxa	desmadre
ham	anzuelo
hostessa	azafata
conhort	consuelo
menhir	menhir
anihilar	aniquilar
exhaurit	agotado
substrahend	sustraendo
ol	olmo
rajola	baldosa
miratge	espejismo
botijós	tartamud
geperut	jorobado
fer fallida	quebrar
fer-se malbé	echarse a perder
desendollar	desenchufar
endoll	enchufe
a cor què vols	a lo grande
a la llunyania	a lo lejos
a la babalà	a lo loco
a tot estirar	a lo sumo
altrament	de lo contrario
pel que fa a	en lo referente a
tant em fa	me da lo mismo
llanterner	fontanero
gens ni mica	ni lo más mínimo
ajornar	aplazar
emmalartir	caer enfermo
bajanada	sandez
mandrós	perezoso
garrepa	tacaño
cadell	cachorro
merla	mirlo
cadernera	jilguero
drapaire	trapero
serf	siervo
oïda	oído
remor	rumor
serena	relente
afront	afrenta
estruç	avestruz
sotsobre	zozobra
gual	vado
ivori	marfil
vellut	terciopelo
beix	beige
nosa	náuseas
safareig	lavadero
fàstic	asco
fastigós	asqueroso
oroneta	golondrina
apegalós	pegajoso
bressol	cuna
esborrall	borrón
esborrador	borrador
afamat	hambriento
lliurar	entregar
fiador	seguro
espelma	vela
botxí	verdugo
pas de vianants	paso de peatones
fadrí	soltero
faula	fábula
gratacel	rascacielos
abonament	entrada
pondre	poner
manilles	esposas
cruïlla	cruce
engegar	poner en marcha
acudit	chiste
traïdoria	alevosía
arrelar	arraigar
farmaciola	botiquín
vessar	derramar
allotjar	alojar
drassana	astillero
saborós	sabroso
esquinç	esguince
testimoni	testigo
aparador	escaparate
xamfrà	xaflán
baixador	apeadero
i tant	desde luego
em trau de pelleguera	me saca de mis casillas
corbata de llaç	pajarita
fermall	broche
metall	metal
fanal	farola
escurar	fregar
crosses	muletas
enxampar	atrapar
ajupir	agacharse
aldarulls	disturbios
espatllar	estropearse
rovellar	oxidar
llavor	semilla
hoste	huésped
falç	hoz
udol	aullido
albir	albedrío
maldestre	torpe
compliment	cumplido
tant de bo	ojalá
comandament	mando
petjapapers	pisapapeles
rosella	amapola
remugar	refunfuñar
clauer	llavero
estiuejar	veranear
teranyina	telaraña
retard	retraso
encenedor	mechero
bugada	colada
aclariment	aclaración
estrenyir	apretar
caragol	tornillo
abast	alcance
marbre	mármol
aplaudiment	aplauso
ruborós	bochornoso
gespa	césped
pressentiment	corazonada
menyspreu	desprecio
robament	robo
serrell	flequillo
franja	flequillo
hivernacle	hivernadero
vímet	mimbre
bolquer	pañal
pèl-roig	pelirrojo
illa	manzana
inversemblant	inverosímil
tornavís	destornillador
deessa	diosa
almoina	limosna
llotja	palco
penedir-se	arrepentirse
mentider	embustero
despessa	gasto
singlot	hipo
a poc a poc	poco a poco
sort que	menos mal que
de sobte	de repente
almenys	por lo menos
sostre	techo
fem	basura
seient	asiento
comanda	pedido
vés en compte	cuidado
bidell	bedel
gema	yema
i escaig	y pico
xiulet	pito
bombeta	bombilla
voltor	buitre
feu	feudo
escaire	escuadra
escuradent	palillo
farcit	relleno